 1, 2, 3, 0, 1, 2, 2, 2, 3
 4, 5, 6, 0, 4, 5, 5, 5, 6
 4, 5, 6, 0, 4, 5, 5, 5, 6
 4, 5,12, 2,13, 5, 5,10, 9
 4, 5, 5, 5, 5, 5,10, 9, 0
 4, 5, 5, 5,10,11, 6, 0, 0
 4, 5, 5, 5, 6, 4, 6, 0, 0
 4, 5, 5, 5, 6, 4, 6, 0, 0
 4, 5, 5, 5,12,13, 6, 0, 0
 7, 8, 8, 8, 8, 8, 9, 0, 0