 1, 2, 2, 2, 2, 2, 2, 2, 3
 4, 5,20, 5, 5, 5, 5, 5, 6
 4, 5, 5, 5, 5, 5,10,11, 6
 4, 5, 5, 5, 5, 5,12,13, 6
 4, 5, 5, 5, 5, 5, 5, 5, 6
 4, 5, 5, 5,30, 5, 5, 5, 6
 4, 5, 5, 5, 5, 5, 5, 5, 6
 4, 5,10,11, 5, 5, 5, 5, 6
 4, 5,12,13, 5, 5,20, 5, 6
 4, 5, 5, 5, 5, 5, 5, 5, 6
 7, 8, 8, 8, 8, 8, 8, 8, 9