 1, 2, 2, 2, 2, 2, 2, 2, 3
 4, 5, 5, 5, 5, 5, 5, 5, 6
 4,10,11, 5, 5, 5, 5, 5, 6
 4,12,13, 5,10,11, 5,10, 9
 4, 5, 5, 5, 6, 4,10, 9, 0
 4, 5, 5, 5, 6, 4, 6, 0, 0
 4, 5, 5, 5, 6, 4, 6, 0, 0
 4, 5, 5, 5, 6, 4, 6, 0, 0
 4, 5, 5, 5,12,13, 6, 0, 0
 7, 8, 8, 8, 8, 8, 9, 0, 0